
NO ./textures_bonus/floor_and_walls/brick.xpm
SO ./textures_bonus/floor_and_walls/red_brick.xpm
WE ./textures_bonus/floor_and_walls/stone_moss.xpm
EA ./textures_bonus/floor_and_walls/purple_stone.xpm

F 220,100,0
C 225,30,0

111111111111111111111111111111111111111111111
100000000000000000000000000000000000000000001
100000000100000000000000000000000000100000001
100000001000000000000000000000000000100000001
100000100000000111111110000000000000100000001
10000000000000010000001000000000000010N000001
100000000000000100000010000000000000000000001
100000000000000100000010000000000000000000001
1000000000000001111D1110000000000000000000001
100000000000000000000000000000000000000000001
100000100000000000000001111111111111D11111111
100000010000000000000001000000000000000000001
10000000100000000000000D000000000000000000001
11111111D111111111111111000000000000000000001
100000000000000000000000000000000000000000001
100000000000000000000000000000000000000000001
100000000000000000000000000000000000000000001111111111111111
100000000000001111111111110000000000000000000000000000000001
100000000000000000000000010000000000000000000000000000000001
100000000000000000000000011111100000000000001111111111111111
100000000000000000000000000000000000000000001
100000000000000000000000000000000000000000001
111111111111111111111111111111111111111111111