NO ./textures/red_wall.xpm
SO ./textures/blue_wall.xpm
WE ./textures/yellow_wall.xpm
EA    ./textures/green_wall.xpm

C   255,2,255

  F   100, 100,0



111111111
100000001
100000001
100100001
100100W01
100000001
111111111
1111  111

EA    ./textures/green_wall.xpm
