

NO ./textures/brick.xpm







SO ./textures/jungle_stone.xpm






WE ./textures/stone_moss.xpm

EA ./textures/yellow_stone.xpm

F 220,100,0

C 225,30,0


        1111111111111111111111111
        1000000000110000000000011
        1011000001110000000000001
        1001000000000000000000011
111111111011000001110000000000001
10000000000000000010111111111111
11110101111111011100000010001
11110111111111011101010000001
11000000110101011100000010001
1000000E000000001100000001001
10000000000000001101010010001
1100000111010101111101111000111
11110001 1110101  10011101001  
11111111 1111111  11111111111
